++++++++++++++++++++++
+   +   ++ ++    S  ++
+     +     +++ ++++++
  +    ++  ++++ +++ ++
+ +   + + ++    +++  +
+          ++  ++  + +
+++++ + +      ++  + +
+++++ +++  + +  ++   +
+          + +  + +  +
+++++ +  + + +     + +
++++++++++++++++++++++